[console_scripts]
Objects = scripts.Objects:main
accession_register = scripts.accession_register:main
aipcreator = scripts.aipcreator:main
as11fixity = scripts.as11fixity:main
batchaipcreator = scripts.batchaipcreator:main
batchdiff_framemd5 = scripts.batchdiff_framemd5:main
batchmakeshell = scripts.batchmakeshell:main
batchsipcreator = scripts.batchsipcreator:main
bitc = scripts.bitc:main
concat = scripts.concat:main
copyit = scripts.copyit:main
dcpaccess = scripts.dcpaccess:main
dcpfixity = scripts.dcpfixity:main
deletefiles = scripts.deletefiles:main
dfxml = scripts.dfxml:main
durationcheck = scripts.durationcheck:main
ffv1mkvvalidate = scripts.ffv1mkvvalidate:main
framemd5 = scripts.framemd5:main
ififuncs = scripts.ififuncs:main
loopline_repackage = scripts.loopline_repackage:main
make_mediaconch = scripts.make_mediaconch:main
makedfxml = scripts.makedfxml:main
makedip = scripts.makedip:main
makeffv1 = scripts.makeffv1:main
makepbcore = scripts.makepbcore:main
makeuuid = scripts.makeuuid:main
makezip = scripts.makezip:main
manifest = scripts.manifest:main
masscopy = scripts.masscopy:main
massqc = scripts.massqc:main
mergepbcore = scripts.mergepbcore:main
multicopy = scripts.multicopy:main
normalise = scripts.normalise:main
order = scripts.order:main
package_update = scripts.package_update:main
packagecheck = scripts.packagecheck:main
prores = scripts.prores:main
seq2ffv1 = scripts.seq2ffv1:main
sipcreator = scripts.sipcreator:main
strongbox_fixity = scripts.strongbox_fixity:main
subfolders = scripts.subfolders:main
testfiles = scripts.testfiles:main
validate = scripts.validate:main
walk_to_dfxml = scripts.walk_to_dfxml:main
